010010110001101110111011101100
111010000000100001011100100101
111010101110001000010100011011
111010011101010100101101110101
111000111001100011010010110011
110101001111000001000101000000
100111000101001110001000000101
111000001110100111010100000010
011000110010110111011001011101
011000000111110110111101110101
101101110000101110101000001011
100011001000100001111101100001
101011101011100001110001010111
011110011001010001101001100001
100111011111010001010000100100
100110101001010101000010011101
001111100011101101110101110111
010001001101101011101000011100
100010111011101011101000010110
000001011111110101001111000011
111111011110001001100101000010
101101001101100111001101000001
001100000010101110010100000011
011110010101010010110001101010
001010000001100110010011110000
110110110000100100011001111111
110110000011011100011000111011
100100011000111110000001001101
110011011011100010111101001001
101101000000110101101000111010